11111111111111111
1N000000000000001
10111111111111101
10000000000000001
10111111111111101
10000000000000001
10111111111111101
10000000000000001
10111111111111101
10000000000000001
10000000200000001
11111111111111111